{"ids":[
1,2,2,5,
0,1,5,7,
0,1,7,7,
5,1,1,5,
2,7,4,4,
0,0,0,0,0,0,0,0]}